#####################################################
#                       #############################
#                       #############################
#                       #############################
#                       #############################
#                       #############################
#                       #############################
#                       #############################
#                       #############################
#                       #############################
#                       #############################
#                       #############################
#                       #############################
#                       #############################
#                       #############################
#                       #############################
#                       #############################
#                       #############################
#                       #############################
#                       #############################
#                       #############################
#                       #############################
#                       #############################
#                       #############################
#####################################################
#                                                   #
#                                                   #
#                                                   #
#                                                   #
#####################################################
